..----------..----------..
..----------..----------..
----..######..######..----
----..######..######..----
----..##..##..##..##..----
----..##..##..##..##..----
----..######..##..##..----
----..######..##..##..----
----......##..##..##..----
----......##..##..##..----
----..######..######..----
----..######..######..----
--------------------------
--------------------------
@@..........@@..........@@
@@........##@@##........@@
%%........######........%%
%%##..##..######..##..##%%
%%##@@##@@######@@##@@##%%
%%##@@##@@######@@##@@##%%
%%##..##..##..##..##..##%%
%%##..##..........##..##%%
%%##..##..........##..##%%
%%##..##...####...##..##%%
%%%%%%.....#..#.....%%%%..
%%%%%%.....#..#.....%%%%..